0,1,1,14,1,1,1,1,2,17,17,17,17,17,17,17
5,19,6,6,6,6,6,15,7,17,17,17,17,17,17,17
5,6,6,6,6,6,15,15,7,17,17,17,17,17,17,17
5,6,6,6,6,6,15,15,8,1,1,1,1,1,1,2
5,6,6,6,6,6,15,19,15,6,6,6,6,6,18,7
5,6,6,6,6,6,6,15,6,6,6,6,6,6,6,7
5,19,6,6,6,6,6,6,6,6,6,6,6,6,19,7
10,11,11,13,11,11,11,11,11,11,11,11,11,11,11,12
